1111111111
1E00000001
1000111101
100P000011
1C01000001
1111111111