1111111
1P00C01
10E0001
1111111
