111111
10PEC1
100001
111111
111111