11111111111111111111
1C100000000001001111
10101C00C11000000111
1000C000100100C00001
1000000100000000C001
100P000011000C000011
1C01000001C000000001
11100010C011E0000001
11111111111111111111