11111111111111111111
10111111110000000111
10000000000000000001
10001111000000000001
100P000000000C00C011
1C0100000000000000E1
11111111111111111111