1111111111111111111111111111111111111111
10101C00C1100000011110101C00C11000000111
1000C000100100C000001000C000100100C00001
1000000100000000C0011000000100000000C001
100P000011000C000011100P000011000C000011
1C01000001C0000000011C01000001C000000001
11100010C011E000000111100010C011E0000001
1111111111111111111111111111111111111111