11111111111111111111111111111111111111111111111111111
1PE00000000000000CCCCCCCCCCCCCCCCCCCCCCCCCCCC00000001
10000000000000000CCCCCCCCCCCCCCCCCCCCCCCCCCCC00000001
10000000000000000CCCCCCCCCCCCCCCCCCCCCCCCCCCC00000001
1CCCCCC01C10CCCC0CCCCCCCCCCCCCCCCCCCCCCCCCCCC00000101
1CCCCCC01C10CCCC0CCCCCCCCCCCCCCCCCCCCCCCCCCCC00000101
1CCCCCC01C10CCCC0CCCCCCCCCCCCCCCCCCCCCCCCCCCC00000101
10000000000000000CCCCCCCCCCCCCCCCCCCCCCCCCCCC00000001
10000000000000000CCCCCCCCCCCCCCCCCCCCCCCCCCCC00000001
10000000000000000CCCCCCCCCCCCCCCCCCCCCCCCCCCC00000001
11011000CCCC0C0C00C0C0C0C0C0C0C0C0C0C0C0C0C0C0C0C0C01
11011000CCCC0C0C00C0C0C0C0C0C0C0C0C0C0C0C0C0C0C0C0C01
11011000CCCC0C0C00C0C0C0C0C0C0C0C0C0C0C0C0C0C0C0C0C01
11011000CCCC0C0C00C0C0C0C0C0C0C0C0C0C0C0C0C0C0C0C0C01
11011000CCCC0C0C00C0C0C0C0C0C0C0C0C0C0C0C0C0C0C0C0C01
11011000CCCC0C0C00C0C0C0C0C0C0C0C0C0C0C0C0C0C0C0C0C01
11111111111111111111111111111111111111111111111111111