1111111111
1C00000101
1000000101
100P000011
1C00000001
1111111111