11111111111
10001P10001
1000C0000E1
101C00C0C11
11111111111
