11111111
1C000C01
10000001
110P0E01
10010011
100C1001
11111111
