1111111111111
1E00000000P01
11100011000C1
1C00C1C100001
11011C1000011
1111111111111
